"a" = (/turf/space,/area/space)
"b" = (/turf/simulated/wall/ocp_wall,/area/space)
"c" = (/obj/machinery/door/airlock/external/bolted,/turf/simulated/floor/airless,/area/space)
"d" = (/obj/machinery/atmospherics/unary/engine{icon_state = "nozzle"; dir = 4},/turf/simulated/wall/ocp_wall,/area/space)
"e" = (/obj/machinery/atmospherics/pipe/simple/visible/fuel{icon_state = "intact"; dir = 4},/turf/simulated/floor/reinforced/airless,/area/space)
"f" = (/turf/simulated/floor/reinforced/airless,/area/space)
"g" = (/turf/simulated/floor/tiled/monotile,/area/space)
"h" = (/obj/machinery/atmospherics/unary/vent_pump/high_volume{icon_state = "map_vent"; dir = 4},/turf/simulated/floor/reinforced/airless,/area/space)
"i" = (/obj/machinery/door/airlock/external/bolted_open,/obj/effect/floor_decal/industrial/warning/fulltile,/turf/simulated/floor/tiled/monotile,/area/space)
"j" = (/turf/simulated/wall,/area/space)
"k" = (/turf/simulated/floor/tiled/white/monotile,/area/space)
"l" = (/turf/simulated/wall/titanium,/area/space)
"m" = (/obj/machinery/door/airlock,/turf/simulated/floor/tiled/monotile,/area/space)
"n" = (/obj/machinery/atmospherics/unary/vent_pump/siphon/on/atmos{icon_state = "map_vent_in"; dir = 4},/turf/simulated/floor/reinforced/airmix,/area/space)
"o" = (/turf/simulated/wall/titanium,/area/ship/Kestrel/doorcontrol)
"p" = (/turf/simulated/wall/titanium,/area/ship/Kestrel/fore)
"q" = (/turf/simulated/wall/titanium,/area/ship/Kestrel/helm)
"r" = (/obj/effect/wallframe_spawn/reinforced/hull,/turf/simulated/floor,/area/ship/Kestrel/helm)
"s" = (/obj/effect/wallframe_spawn/reinforced,/obj/machinery/atmospherics/binary/passive_gate/on{dir = 4; icon_state = "map_on"; target_pressure = 300},/turf/simulated/floor,/area/space)
"t" = (/obj/machinery/computer/air_control{icon_state = "computer"; dir = 8},/turf/simulated/floor/tiled/white/monotile,/area/space)
"u" = (/turf/simulated/floor/reinforced/airmix,/area/space)
"v" = (/obj/effect/wallframe_spawn/reinforced,/turf/simulated/floor,/area/space)
"w" = (/turf/simulated/wall,/area/ship/Kestrel/doorcontrol)
"x" = (/obj/structure/table/standard,/turf/simulated/floor/tiled/white/monotile,/area/ship/Kestrel/doorcontrol)
"y" = (/obj/machinery/door/airlock,/obj/effect/floor_decal/industrial/warning/fulltile,/turf/simulated/floor/tiled/monotile,/area/space)
"z" = (/turf/simulated/floor/tiled/white/monotile,/area/ship/Kestrel/fore)
"A" = (/turf/simulated/wall,/area/ship/Kestrel/helm)
"B" = (/obj/machinery/computer/ship/sensors,/turf/simulated/floor/tiled/white/monotile,/area/ship/Kestrel/helm)
"C" = (/obj/machinery/door/airlock/external/bolted,/turf/simulated/floor/tiled/monotile,/area/space)
"D" = (/turf/simulated/floor/tiled/white/monotile,/area/ship/Kestrel/doorcontrol)
"E" = (/obj/structure/bed/chair/shuttle/white{icon_state = "shuttle_chair_preview"; dir = 4},/turf/simulated/floor/tiled/white/monotile,/area/ship/Kestrel/helm)
"F" = (/turf/simulated/wall/titanium,/area/ship/Kestrel/monitoring)
"G" = (/obj/effect/floor_decal/industrial/warning/fulltile,/obj/machinery/door/airlock,/turf/simulated/floor/tiled/monotile,/area/space)
"H" = (/obj/machinery/door/airlock,/obj/effect/floor_decal/industrial/warning/fulltile,/obj/effect/floor_decal/industrial/warning/fulltile,/turf/simulated/floor/tiled/monotile,/area/space)
"I" = (/obj/machinery/computer/ship/helm{icon_state = "computer"; dir = 8},/turf/simulated/floor/tiled/white/monotile,/area/ship/Kestrel/helm)
"J" = (/turf/simulated/wall,/area/ship/Kestrel/monitoring)
"K" = (/turf/simulated/floor/tiled/white/monotile,/area/ship/Kestrel/helm)
"L" = (/turf/simulated/floor/tiled/white/monotile,/area/ship/Kestrel/monitoring)
"M" = (/obj/machinery/computer/ship/navigation{icon_state = "computer"; dir = 8},/turf/simulated/floor/tiled/white/monotile,/area/ship/Kestrel/helm)
"N" = (/obj/item/modular_computer/console/preset/engineering{icon_state = "console"; dir = 4},/turf/simulated/floor/tiled/white/monotile,/area/ship/Kestrel/monitoring)
"O" = (/obj/structure/bed/chair/comfy{icon_state = "comfychair_preview"; dir = 4},/turf/simulated/floor/tiled/white/monotile,/area/ship/Kestrel/monitoring)
"P" = (/obj/item/modular_computer/console/preset/security{icon_state = "console"; dir = 8},/turf/simulated/floor/tiled/white/monotile,/area/ship/Kestrel/monitoring)
"Q" = (/obj/item/modular_computer/console/preset/sysadmin{icon_state = "console"; dir = 1},/turf/simulated/floor/tiled/white/monotile,/area/ship/Kestrel/monitoring)
"R" = (/obj/machinery/computer/ship/engines{icon_state = "computer"; dir = 1},/turf/simulated/floor/tiled/white/monotile,/area/ship/Kestrel/helm)
"S" = (/obj/machinery/door/airlock,/obj/effect/floor_decal/industrial/warning/fulltile,/turf/simulated/floor/tiled/monotile,/area/ship/Kestrel/doorcontrol)
"T" = (/obj/machinery/door/airlock,/obj/effect/floor_decal/industrial/warning/fulltile,/turf/simulated/floor/tiled/monotile,/area/ship/Kestrel/helm)
"U" = (/obj/machinery/door/airlock,/obj/effect/floor_decal/industrial/warning/fulltile,/obj/effect/floor_decal/industrial/warning/fulltile,/turf/simulated/floor/tiled/monotile,/area/ship/Kestrel/monitoring)
"V" = (/obj/machinery/door/airlock,/obj/effect/floor_decal/industrial/warning/fulltile,/turf/simulated/floor/tiled/monotile,/area/ship/Kestrel/monitoring)

(1,1,1) = {"
aaaaaaaaaaaaaaaaaaaaaaaaaaaaaaaaaaaaaaaaaaaaaaaaaaaaaaaaaaaaaaaaaaaaaaaaaaaaaaaa
aaaaaaaaaaaaaaaaaaaaaaaaaaaaaaaaaaaaaaaaaaaaaaaaaaaaaaaaaaaaaaaaaaaaaaaaaaaaaaaa
aaaaaaaaaaaaaaaaaaaaaaaaaaaaaaaaaaaaaaaaaaaaaaaaaaaaaaaaaaaaaaaaaaaaaaaaaaaaaaaa
aaaaaaaaaaaaaaaaaaaaaaaaaaaaaaaaaaaaaaaaaaaaaaaaaaaaaaaaaaaaaaaaaaaaaaaaaaaaaaaa
aaaaaaaaaaaaaaaaaaaaaaaaaaaaaaaaaaaaaaaaaaaaaaaaaaaaaaaaaaaaaaaaaaaaaaaaaaaaaaaa
aaaaaaaaaaaaaaaaaaaaaaaaaaaaaaaaaaaaaaaaaaaaaaaaaaaaaaaaaaaaaaaaaaaaaaaaaaaaaaaa
aaaaaaaaaaaaaaaaaaaaaaaaaaaaaaaaaaaaaaaaaaaaaaaaaaaaaaaaaaaaaaaaaaaaaaaaaaaaaaaa
aaaaaaaaaaaaaaaaaaaaaaaaaaaaaaaaaaaaaaaaaaaaaaaaaaaaaaaaaaaaaaaaaaaaaaaaaaaaaaaa
aaaaaaaaaaaaaaaaaaaaaaaaaaaaaaaaaaaaaaaaaaaaaaaaaaaaaaaaaaaaaaaaaaaaaaaaaaaaaaaa
aaaaaaaaaaaaaaaaaaaaaaaaaaaaaaaaaaaaaaaaaaaaaaaaaaaaaaaaaaaaaaaaaaaaaaaaaaaaaaaa
aaaaaaaaaaaaaaaaaaaaaaaaaaaaaaaaaaaaaaaaaaaaaaaaaaaaaaaaaaaaaaaaaaaaaaaaaaaaaaaa
aaaaaaaaaaaaaaaaaaaaaaaaaaaaaaaaaaaaaaaaaaaaaaaaaaaaaaaaaaaaaaaaaaaaaaaaaaaaaaaa
aaaaaaaaaaaaaaaaaaaaaaaaaaaaaaaaaaaaaaaaaaaaaaaaaaaaaaaaaaaaaaaaaaaaaaaaaaaaaaaa
aaaaaaaaaaaaaaaaaaaaaaaaaaaaaaaaaaaaaaaaaaaaaaaaaaaaaaaaaaaaaaaaaaaaaaaaaaaaaaaa
aaaaaaaaaaaaaaaaaaaaaaaaaaaaaaaaaaaaaaaaaaaaaaaaaaaaaaaaaaaaaaaaaaaaaaaaaaaaaaaa
aaaaaaaaaaaaaaaaaaaaaaaaaaaaaaaaaaaaaaaaaaaaaaaaaaaaaaaaaaaaaaaaaaaaaaaaaaaaaaaa
aaaaaaaaaaaaaaaaaaaaaaaaaaaaaaaaaaaaaaaaaaaaaaaaaaaaaaaaaaaaaaaaaaaaaaaaaaaaaaaa
aaaaaaaaaaaaaaaaaaaaaaaaaaaaaaaaaaaaaaaaaaaaaaaaaaaaaaaaaaaaaaaaaaaaaaaaaaaaaaaa
aaaaaaaaaaaaaaaaaaaaaaaalbbblllllllllllaaaaaaaaaaaaaaaaaaaaaaaaaaaaaaaaaaaaaaaaa
aaaaaaaaaaaaaaaaaaaaaaaadefhbggggggggglaaaaaaaaaaaaaaaaaaaaaaaaaaaaaaaaaaaaaaaaa
aaaaaaaaaaaaaaaaaaaaaaaabfffbggggggggglaaaaaaaaaaaaaaaaaaaaaaaaaaaaaaaaaaaaaaaaa
aaaaaaaaaaaaaaaaaaaaaaaadefhbggggggggglaaaaaaaaaaaaaaaaaaaaaaaaaaaaaaaaaaaaaaaaa
aaaaaaaaaaaaaaaaaaaaaaaabfffbgggggggggllccllaaaaaaaaaaaaaaaaaaaaaaaaaaaaaaaaaaaa
aaaaaaaaaaaaaaaaaaaaaaaadefhbgggggggggjkkkkllaaaaaaaaaaaaaaaaaaaaaaaaaaaaaaaaaaa
aaaaaaaaaaaaaaaaaaaaaaaalbbbjjjjjjjjggjkkkkjllaaaaaaaaaaaaaaaaaaaaaaaaaaaaaaaaaa
aaaaaaaaaaaaaaaaaaaaaaaaalnsktjkkkkjggjjjijjjlllllaaaaaaaaaaaaaaaaaaaaaaaaaaaaaa
aaaaaaaaaaaaaaaaaaaaaaaaaluvkkykkkkjggjkkkkjkkkklllaaaaaaaaaaaaaaaaaaaaaaaaaaaaa
aaaaaaaaaaaaaaaaaaaaaalllljjyjjjjjmjGjjkkkkHkkkkwwooooppppqqraaaaaaaaaaaaaaaaaaa
aaaaaaaaaaaaaaaaaaaaaalkkjkkkkkkjkkkkkykkkkjkkkkwxxxxwzzzzABrraaaaaaaaaaaaaaaaaa
aaaaaaaaaaaaaaaaaaaaaaCkkikkkkkkjkkkkkjkkkkjkkkkSDDDDSzzzzAEIraaaaaaaaaaaaaaaaaa
aaaaaaaaaaaaaaaaaaaaaalkkjkkkkkkjkkkkkjjjjjjjjjjJJJJJJzzzzTKKqaaaaaaaaaaaaaaaaaa
aaaaaaaaaaaaaaaaaaaaaaCkkikkkkkkjkkkkkjkkkkjkkkkULLLLVzzzzAEMraaaaaaaaaaaaaaaaaa
aaaaaaaaaaaaaaaaaaaaaalkkjkkkkkkjkkkkkykkkkjkkkkJNOPQJzzzzARrraaaaaaaaaaaaaaaaaa
aaaaaaaaaaaaaaaaaaaaaalllljjyjjjjjyjGjjkkkkykkkkJJFFFFppppqqraaaaaaaaaaaaaaaaaaa
aaaaaaaaaaaaaaaaaaaaaaaaalkkkkykkkkjggjkkkkjkkkklllaaaaaaaaaaaaaaaaaaaaaaaaaaaaa
aaaaaaaaaaaaaaaaaaaaaaaaalkkkkjkkkkjggjjjijjjlllllaaaaaaaaaaaaaaaaaaaaaaaaaaaaaa
aaaaaaaaaaaaaaaaaaaaaaaalbbbjjjjjjjjggjkkkkjllaaaaaaaaaaaaaaaaaaaaaaaaaaaaaaaaaa
aaaaaaaaaaaaaaaaaaaaaaaadefhbgggggggggjkkkkllaaaaaaaaaaaaaaaaaaaaaaaaaaaaaaaaaaa
aaaaaaaaaaaaaaaaaaaaaaaabfffbgggggggggllccllaaaaaaaaaaaaaaaaaaaaaaaaaaaaaaaaaaaa
aaaaaaaaaaaaaaaaaaaaaaaadefhbggggggggglaaaaaaaaaaaaaaaaaaaaaaaaaaaaaaaaaaaaaaaaa
aaaaaaaaaaaaaaaaaaaaaaaabfffbggggggggglaaaaaaaaaaaaaaaaaaaaaaaaaaaaaaaaaaaaaaaaa
aaaaaaaaaaaaaaaaaaaaaaaadefhbggggggggglaaaaaaaaaaaaaaaaaaaaaaaaaaaaaaaaaaaaaaaaa
aaaaaaaaaaaaaaaaaaaaaaaalbbblllllllllllaaaaaaaaaaaaaaaaaaaaaaaaaaaaaaaaaaaaaaaaa
aaaaaaaaaaaaaaaaaaaaaaaaaaaaaaaaaaaaaaaaaaaaaaaaaaaaaaaaaaaaaaaaaaaaaaaaaaaaaaaa
aaaaaaaaaaaaaaaaaaaaaaaaaaaaaaaaaaaaaaaaaaaaaaaaaaaaaaaaaaaaaaaaaaaaaaaaaaaaaaaa
aaaaaaaaaaaaaaaaaaaaaaaaaaaaaaaaaaaaaaaaaaaaaaaaaaaaaaaaaaaaaaaaaaaaaaaaaaaaaaaa
aaaaaaaaaaaaaaaaaaaaaaaaaaaaaaaaaaaaaaaaaaaaaaaaaaaaaaaaaaaaaaaaaaaaaaaaaaaaaaaa
aaaaaaaaaaaaaaaaaaaaaaaaaaaaaaaaaaaaaaaaaaaaaaaaaaaaaaaaaaaaaaaaaaaaaaaaaaaaaaaa
aaaaaaaaaaaaaaaaaaaaaaaaaaaaaaaaaaaaaaaaaaaaaaaaaaaaaaaaaaaaaaaaaaaaaaaaaaaaaaaa
aaaaaaaaaaaaaaaaaaaaaaaaaaaaaaaaaaaaaaaaaaaaaaaaaaaaaaaaaaaaaaaaaaaaaaaaaaaaaaaa
aaaaaaaaaaaaaaaaaaaaaaaaaaaaaaaaaaaaaaaaaaaaaaaaaaaaaaaaaaaaaaaaaaaaaaaaaaaaaaaa
aaaaaaaaaaaaaaaaaaaaaaaaaaaaaaaaaaaaaaaaaaaaaaaaaaaaaaaaaaaaaaaaaaaaaaaaaaaaaaaa
aaaaaaaaaaaaaaaaaaaaaaaaaaaaaaaaaaaaaaaaaaaaaaaaaaaaaaaaaaaaaaaaaaaaaaaaaaaaaaaa
aaaaaaaaaaaaaaaaaaaaaaaaaaaaaaaaaaaaaaaaaaaaaaaaaaaaaaaaaaaaaaaaaaaaaaaaaaaaaaaa
aaaaaaaaaaaaaaaaaaaaaaaaaaaaaaaaaaaaaaaaaaaaaaaaaaaaaaaaaaaaaaaaaaaaaaaaaaaaaaaa
aaaaaaaaaaaaaaaaaaaaaaaaaaaaaaaaaaaaaaaaaaaaaaaaaaaaaaaaaaaaaaaaaaaaaaaaaaaaaaaa
aaaaaaaaaaaaaaaaaaaaaaaaaaaaaaaaaaaaaaaaaaaaaaaaaaaaaaaaaaaaaaaaaaaaaaaaaaaaaaaa
aaaaaaaaaaaaaaaaaaaaaaaaaaaaaaaaaaaaaaaaaaaaaaaaaaaaaaaaaaaaaaaaaaaaaaaaaaaaaaaa
aaaaaaaaaaaaaaaaaaaaaaaaaaaaaaaaaaaaaaaaaaaaaaaaaaaaaaaaaaaaaaaaaaaaaaaaaaaaaaaa
"}
